1111111111
100CE000C1
111111P101
10C0011001
1111111111
