1111111111
1ECCCCCC11
1CCCCCCC11
1CCCCCCC11
1CCCCCCP11
1111111111
