EA ./textures/4.xpm

WE ./textures/3.xpm




SO ./textures/2.xpm




NO ./textures/1.xpm







F 255,255,252


C 0,0,0

    1    111111111              111111111111111111111
   101   100000001              11100000000000011111
    1    101100001       1     11100000000000001
        100100001              100000000000000111111
11111111101100001              1110000000000001111111
10000000001100001        1      1110111111111111
11110111111111011              100000010001
11111111111111111              111111111111
    1             1                               1   
11111111111111111              111111111111
11110111111111011              101010010001
11000000110101011              100000010001
10S00000000000001              100000010001
10000000000000001              101010010001
11000001110101011      1       11101111000111
11110111 1110101               101111010001
11110111 1111111               111111111111
1111111111111111111111111111111111111111111111111111

